###############################
###############################
###############################
########E####E#################
########CC##CC#################
#######CCCCCCCC##CS############
#######CCCCCCCC##CC############
#######C#CC#CCCCCC#############
#######C X  CCCC ##############
########         ##############
#########        ##############
#########HHHHHHHH##############
###############################
###############################
###############################
