###############################
#           #     #       #   #
# # ####### # # # ### # # ### #
# # #     # # # #   # # #   # #
# # # ### # ### ### ### ### # #
# # # # # #     #X#     #   # #
# ### # # ####### ####### ### #
# #   # #   #   #       #   # #
# # ### ### ###     ### ### # #
# #       #   #  CCC  #   #   #
# ####### ### ####### # ##### #
#     #   # #   #     # #     #
# ### # ### # ### ##### # #####
#   #       #     #           #
###############################
