▒▒▒▒▒▒▒▒▒▒▒▒▒▒▒▒▒▒▒▒▒▒▒▒▒▒▒▒▒▒▒▒
▒▒======= ВИБIР РIВНЯ ========▒▒
▒▒||▒▒▒▒▒▒▒▒▒▒▒▒▒▒▒▒▒▒▒▒▒▒▒▒||▒▒
▒▒||▒▒1. LVL1▒▒▒▒▒4. LVL1▒▒▒||▒▒
▒▒||▒▒▒▒▒▒▒▒▒▒▒▒▒▒▒▒▒▒▒▒▒▒▒▒||▒▒
▒▒||▒▒2. LVL2▒▒▒▒▒5. LVL1▒▒▒||▒▒
▒▒||▒▒▒▒▒▒▒▒▒▒▒▒▒▒▒▒▒▒▒▒▒▒▒▒||▒▒
▒▒||▒▒3. LVL3▒▒▒▒▒6. LVL1▒▒▒||▒▒
▒▒||▒▒▒▒▒▒▒▒▒▒▒▒▒▒▒▒▒▒▒▒▒▒▒▒||▒▒
▒▒||▒▒▒▒▒▒▒▒▒▒▒▒▒▒▒▒▒▒▒▒▒▒▒▒||▒▒
▒▒||▒▒▒▒▒▒▒▒▒▒▒▒▒▒▒▒▒▒▒▒▒▒▒▒||▒▒
▒▒============================▒▒
▒▒▒▒▒▒▒▒▒▒▒▒▒▒▒▒▒▒▒▒▒▒▒▒▒▒▒▒▒▒▒▒