▒▒▒▒▒▒▒▒▒▒▒▒▒▒▒▒▒▒▒▒▒▒▒▒▒▒▒▒▒▒▒▒
▒▒======= ГОЛОВНЕ МЕНЮ =======▒▒
▒▒||▒▒▒▒▒▒▒▒▒▒▒▒▒▒▒▒▒▒▒▒▒▒▒▒||▒▒
▒▒||▒▒1. Iм’я:          ▒▒▒▒||▒▒
▒▒||▒▒▒▒▒▒▒▒▒▒▒▒▒▒▒▒▒▒▒▒▒▒▒▒||▒▒
▒▒||▒▒2. Обрати рiвень  ▒▒▒▒||▒▒
▒▒||▒▒▒▒▒▒▒▒▒▒▒▒▒▒▒▒▒▒▒▒▒▒▒▒||▒▒
▒▒||▒▒3. Магазин        ▒▒▒▒||▒▒
▒▒||▒▒▒▒▒▒▒▒▒▒▒▒▒▒▒▒▒▒▒▒▒▒▒▒||▒▒
▒▒||▒▒▒▒▒▒▒▒▒▒▒▒▒▒▒▒▒▒▒▒▒▒▒▒||▒▒
▒▒||▒▒▒▒▒▒▒▒▒▒▒▒▒▒▒▒▒▒▒▒▒▒▒▒||▒▒
▒▒============================▒▒
▒▒▒▒▒▒▒▒▒▒▒▒▒▒▒▒▒▒▒▒▒▒▒▒▒▒▒▒▒▒▒▒