▒▒▒▒▒▒▒▒▒▒▒▒▒▒▒▒▒▒▒▒▒▒▒▒▒▒▒▒▒▒▒▒
▒▒========== МАГАЗИН =========▒▒
▒▒||▒▒▒▒▒▒▒▒▒▒▒▒▒▒▒▒▒▒▒▒▒▒▒▒||▒▒
▒▒||▒▒▒▒▒▒▒▒▒▒▒▒▒▒▒▒▒▒▒▒▒▒▒▒||▒▒
▒▒||▒1. Бомбочка  15 ● ▒▒▒▒▒||▒▒
▒▒||▒Руйнує стіну      ▒▒▒▒▒||▒▒
▒▒||▒▒▒▒▒▒▒▒▒▒▒▒▒▒▒▒▒▒▒▒▒▒▒▒||▒▒
▒▒||▒2. Магнiт    20 ● ▒▒▒▒▒||▒▒
▒▒||▒Притягує монетки  ▒▒▒▒▒||▒▒
▒▒||▒▒▒▒▒▒▒▒▒▒▒▒▒▒▒▒▒▒▒▒▒▒▒▒||▒▒
▒▒============================▒▒
▒▒▒▒▒▒▒▒▒▒▒▒▒▒▒▒▒▒▒▒▒▒▒▒▒▒▒▒▒▒▒▒